NO ./texture/1337.png
SO ./texture/codiing.png
WE ./texture/maroc.png
EA ./texture/hacker.png

F 20,0,80
C 200,200,150

1111111111111111111111111
1000000000110000000000001
1011000001110000000000001
1001000000000000000000001
1111111110110000011100001
1000000000110000011100111
1111011111111101110000101
1111011111111101110100011
1000000000000000110000101
11000000110101011100N1001
1111111111111111111111111
